Variable Assignment

    Simply use = for assigning values to variables. The data type is inferred from the value. For example:
    n = 1 (integer)
    pi = 3.14 (float)
    name = "Alice" (string)
    flag = True (boolean)

Input/Output

    Print: To display output.
    Input: To get input from the user.

Mathematical Operations

    Add: Addition.
    Subtract: Subtraction.
    Multiply: Multiplication.
    Divide: Division.

Comparative Operators

    Equals: Equality check.
    NotEquals: Inequality check.
    LessThan: Less than.
    GreaterThan: Greater than.
    LessOrEqual: Less than or equal to.
    GreaterOrEqual: Greater than or equal to.

Logical Operators

    And: Logical AND.
    Or: Logical OR.
    Not: Logical NOT.

Control Flow

    If: Conditional execution.
    Else: Alternative branch for If.
    While: Loop with a condition at the beginning.
    For: Loop with a predefined number of iterations.

Function Definition and Control

    Function: Define a function.
    Return: Return a value from a function.
    Call: Call a function.
    Efter the Try and Catch, regardless of whether an error occurred.

Comments

    Comment: To add non-executable remarks in the code.